111111111111
100100000001
10P001110101
101101C10101
10000001C101
111111111101
1E000CC0C001
111111111111
