1111111111111111111
1P00010000000000001
1C00010000000011101
111001001C111D10101
100C000000000000E01
1111111111111111111