1111111111111111111
100001000000000000
1000010000000011101
1110010010111010101
100000P000D000E0C01
1111111111111110111