1111111111111111111
1000D10000000D00001
1C000100000000111D1
111001001C111010101
100C000000D0000E0P1
1111111111111111111