1111111111111111111
1P00010000000000001
1C00010000000011101
111001001C111010101
100C01000000000E001
1111111111111111111