1111111111111
1E00000000101
1000C0P000011
1000000000001
1000000000001
1000000000001
1000000000001
1000000000001
1111111111111